You wake up in a dark and messy room with a serious headache surrounded by medicine pills and syringes with no recollection of any events withing the last few days.

CECS_424_1
An Interactive Fiction by Mukesh
Release 1 / Serial number 170209 / Inform 7 build 6M62 (I6/v6.33 lib 6/12N) SD

Medical bay
You shiver and see a dirty old blanket.

That blanket could really help, it's freezing in here.

>y
That was a rhetorical question.

>n
You can't go that way.

>no
That was a rhetorical question.

>yes
That was a rhetorical question.

* * *

You wake up in a dark and messy room with a serious headache surrounded by medicine pills and syringes with no recollection of any events withing the last few days.

CECS_424_1
An Interactive Fiction by Mukesh
Release 1 / Serial number 170209 / Inform 7 build 6M62 (I6/v6.33 lib 6/12N) SD

Medical bay
You shiver and see a dirty old blanket.

That blanket could really help, it's freezing in here.

>w
You can't go that way.

>n
You can't go that way.

>e
You can't go that way.

>z
Time passes.

>z
Time passes.

* * *

>w
You can't go that way.

>e
There are plenty of corpses here compared to other times, did something happen?

You cannot go further in this condition, it's freezing out there.

>n
Garden

>e
Food Market

>w
Garden

>w
Chemical storage

>w
You can't go that way.

>e
Garden

>n
Security Station

>e
Armory

>w
Security Station

>s
Garden

>e
Food Market

>e
Crew Quarters

>n
Systems Administration

>n
Bridge

>n
Command Center

>n
Captain's Quarter

* * *

>e
There are plenty of corpses here compared to other times, did something happen?

You cannot go further in this condition, it's freezing out there.

>w
You can't go that way.

>take blanket
You can't see any such thing.

* * *

You wake up in a dark and messy room with a serious headache surrounded by medicine pills and syringes with no recollection of any events withing the last few days.

CECS_424_1
An Interactive Fiction by Mukesh
Release 1 / Serial number 170209 / Inform 7 build 6M62 (I6/v6.33 lib 6/12N) SD

Medical bay
You shiver and see a dirty old blanket.

That blanket could really help, it's freezing in here.

>e
You cannot go further in this condition, it's freezing out there.

>w
You can't go that way.

* * *

>n
You can't go that way.

>s
You can't go that way.

>go
You'll have to say which compass direction to go in.

>e
You can't go that way.

>go east
You can't go that way.

* * *

>e
You cannot go further in this condition, it's freezing out there.

>n
You can't go that way.

>w
There is a giant image of what appears to be the planet Earth, but it looks so life like...... upon investigating, it may actually be Earth. There's another room up ahead with even brighter lights.

Observatory

>e
Garden

* * *

>w
There is a giant image of what appears to be the planet Earth, but it looks so life like...... upon investigating, it may actually be Earth. There's another room up ahead with even brighter lights.

Observatory

>u
You can't go that way.

>w
There appears to be a giant sign indicating that this is the Space Room, some kind of museum dedicated to the universe, upon wandering around, you see a gigantic window that appears to showcase planet Earth along with plenty of stars. There's also some kind of clock that indicates that it is 9:43 pm with the date: August 11, 2072. Your head starts to ache and hurt a lot from wandering this room.

Space room

>e
There is a giant image of what appears to be the planet Earth, but it looks so life like...... upon investigating, it may actually look like Earth. There's another room up ahead with even brighter lights.

Observatory

>e
This Garden Grove is very beautiful, filled luscious life of both Flora and Fauna, however their was bright ray of light coming from the western part of the Garden while the others remain dark.

Garden

>u
You can't go that way.

>n
Security Station

* * *

>w
There is a giant image of what appears to be the planet Earth, but it looks so life like...... upon investigating, it may actually be Earth. There's another room up ahead with even brighter lights.

Observatory

>w
There appears to be a giant sign indicating that this is the Space Room, some kind of museum dedicated to our universe, upon wandering around, you see a gigantic window that appears to showcase planet Earth along with a vast array of stars.  It turns out you are actually on a Faster Than Light travel Spaceship called The S.S. Von Falkner, based upon various flyers posted on walls around. There's also some kind of clock that indicates that it is 9:43 pm with the date: August 11, 2172. Your head starts to ache and hurt a lot from wandering around this room. There appears to be a trail of blood going up north from here
Space Room

>u
You can't go that way.

>n
There appears to be a man, laying down in the cold hard ground. There appears to be recording device next to him. The recording comes from a man Leo Tolkien saying, Damn, I can't believe the captatin is making me change my shift from Security Station duty to be being a Tour Guide for any weirdos out there who just want others to state the obvious about the universe. Why does it have to be me? Anyway, I was also told to change the keypad locks for the Security Station, Armory, and the Food Market in case something goes down, not that anything will. The new combination is 00451. Also I'm recording this in case I forget myself from all this boredom I'm dealing with.

Staff Room

>s
There appears to be a giant sign indicating that this is the Space Room, some kind of museum dedicated to our universe, upon wandering around, you see a gigantic window that appears to showcase planet Earth along with a vast array of stars.  It turns out you are actually on a Faster Than Light travel Spaceship called The S.S. Von Falkner, based upon various flyers posted on walls around. There's also some kind of clock that indicates that it is 9:43 pm with the date: August 11, 2172. Your head starts to ache and hurt a lot from wandering around this room. There appears to be a trail of blood going up north from here
Space Room

>e
There is a giant image of what appears to be the planet Earth, but it looks so life like...... upon investigating, it may actually be Earth. There's another room up ahead with even brighter lights.

Observatory

>e
This Garden Grove is very beautiful, filled luscious life of both Flora and Fauna, however plants here have been tainted in red liquid. It appears to be blood. Their was a bright ray of light coming from the western part of the Garden while the others remain dark.

Garden

>n
Security Station

* * *

>w
You can't go that way.

>n
There appears to be a man, laying down in the cold hard ground. There appears to be recording device next to him. The recording comes from a man Leo Tolkien saying, Damn, I can't believe the captatin is making me change my shift from Security Station duty to be being a Tour Guide for any weirdos out there who just want others to state the obvious about the universe. Why does it have to be me? Anyway, I was also told to change the keypad locks for the Security Station and the Armory in case something goes down, not that anything will. The new combination is 00451. Also I'm recording this in case I forget myself from all this boredom I'm dealing with.

Staff Room
Hmmm....maybe that keycode is important.

>take keycode
Taken.

>s
There appears to be a giant sign indicating that this is the Space Room, some kind of museum dedicated to our universe, upon wandering around, you see a gigantic window that appears to showcase planet Earth along with a vast array of stars.  It turns out you are actually on a Faster Than Light travel Spaceship called The S.S. Von Falkner, based upon various flyers posted on walls around. There's also some kind of clock that indicates that it is 9:43 pm with the date: August 11, 2172. Your head starts to ache and hurt a lot from wandering around this room. There appears to be a trail of blood going up north from here
Space Room

* * *

>e
This Garden Grove is very beautiful, filled luscious life of both Flora and Fauna, however plants here have been tainted in red liquid. It appears to be blood. Their was a bright ray of light coming from the western part of the Garden while the others remain dark.

Garden

>n
You've used the keycode: 00451 to enter the Security Station.

You've enter the Security Station... however it's filled with deceased Security Guard members, there's an open door leading to the Armory from here

>e
Armory
Hmmm....maybe that keycode1 is important.

>w
You've used the keycode: 00451 to enter the Security Station.

You've enter the Security Station... however it's filled with deceased Security Guard members, there's an open door leading to the Armory from here

>s
This Garden Grove is very beautiful, filled luscious life of both Flora and Fauna, however plants here have been tainted in red liquid. It appears to be blood. Their was a bright ray of light coming from the western part of the Garden while the others remain dark.

Garden

>n
You've used the keycode: 00451 to enter the Security Station.

You've enter the Security Station... however it's filled with deceased Security Guard members, there's an open door leading to the Armory from here

* * *

>e
Armory
Hmmm....maybe that keycode1 is important.

>take keycode1
Taken.

>w
You've used the keycode: 00451 to enter the Security Station.

You've enter the Security Station... however it's filled with deceased Security Guard members, there's an open door leading to the Armory from here

* * *

>s
This Garden Grove is very beautiful, filled luscious life of both Flora and Fauna, however plants here have been tainted in red liquid. It appears to be blood. Their was a bright ray of light coming from the western part of the Garden while the others remain dark.

Garden

>e
You've entered the Food Market part of the ship!

I remember this place, the Infamous Food Market where the food is light years expired and terrible where anything on Earth is better than what's here, at least it's better than what the first astronaughts had to eat.

* * *

>n
You can't go that way.

>n
You cannot enter without some kind of keycode

>n
You cannot enter

>w
There is a giant image of what appears to be the planet Earth, but it looks so life like...... upon investigating, it may actually be Earth. There's another room up ahead with even brighter lights.

Observatory

* * *

>n
There appears to be a man, laying down in the cold hard ground. There appears to be recording device next to him. The recording comes from a man Leo Tolkien saying, Damn, I can't believe the captatin is making me change my shift from Security Station duty to be being a Tour Guide for any weirdos out there who just want others to state the obvious about the universe. Why does it have to be me? Anyway, I was also told to change the keypad locks for the Security Station, Armory, and the Food Market in case something goes down, not that anything will. The new combination is 00451. Also I'm recording this in case I forget myself from all this boredom I'm dealing with.

Staff Room
You've obtained a keycode along with the recording of the man.

>s
There appears to be a giant sign indicating that this is the Space Room, some kind of museum dedicated to our universe, upon wandering around, you see a gigantic window that appears to showcase planet Earth along with a vast array of stars.  It turns out you are actually on a Faster Than Light travel Spaceship called The S.S. Von Falkner, based upon various flyers posted on walls around. There's also some kind of clock that indicates that it is 9:43 pm with the date: August 11, 2172. Your head starts to ache and hurt a lot from wandering around this room. There appears to be a trail of blood going up north from here
Space Room

* * *

>e
This Garden Grove is very beautiful, filled luscious life of both Flora and Fauna, however plants here have been tainted in red liquid. It appears to be blood. Their was a bright ray of light coming from the western part of the Garden while the others remain dark.

Garden

>n
You cannot enter

>n
You cannot enter

* * *

>n
You cannot enter without some kind of keycode

>w
There is a giant image of what appears to be the planet Earth, but it looks so life like...... upon investigating, it may actually be Earth. There's another room up ahead with even brighter lights.

Observatory

* * *

>n
Staff Room
Hmmm....maybe that keycode is important.

>n
You can't go that way.

>s
There appears to be a giant sign indicating that this is the Space Room, some kind of museum dedicated to our universe, upon wandering around, you see a gigantic window that appears to showcase planet Earth along with a vast array of stars.  It turns out you are actually on a Faster Than Light travel Spaceship called The S.S. Von Falkner, based upon various flyers posted on walls around. There's also some kind of clock that indicates that it is 9:43 pm with the date: August 11, 2172. Your head starts to ache and hurt a lot from wandering around this room. There appears to be a trail of blood going up north from here
Space Room

>s
You can't go that way.

>e
There is a giant image of what appears to be the planet Earth, but it looks so life like...... upon investigating, it may actually be Earth. There's another room up ahead with even brighter lights.

Observatory

* * *

>n
Staff Room
Hmmm....maybe that keycode is important.

>s
There appears to be a giant sign indicating that this is the Space Room, some kind of museum dedicated to our universe, upon wandering around, you see a gigantic window that appears to showcase planet Earth along with a vast array of stars.  It turns out you are actually on a Faster Than Light travel Spaceship called The S.S. Von Falkner, based upon various flyers posted on walls around. There's also some kind of clock that indicates that it is 9:43 pm with the date: August 11, 2172. Your head starts to ache and hurt a lot from wandering around this room. There appears to be a trail of blood going up north from here
Space Room

* * *

>n
You cannot enter

I beg your pardon?

>s
There are plenty of corpses here compared to other times, did something happen?

Morgue
You can see a widely open door here.

>n
This Garden Grove is very beautiful, filled luscious life of both Flora and Fauna, however plants here have been tainted in red liquid. It appears to be blood. Their was a bright ray of light coming from the western part of the Garden while the others remain dark.

Garden

>w
There is a giant image of what appears to be the planet Earth, but it looks so life like...... upon investigating, it may actually be Earth. There's another room up ahead with even brighter lights.

Observatory

* * *

>n
There appears to be a man, laying down in the cold hard ground. There appears to be recording device next to him. The recording comes from a man Leo Tolkien saying, Damn, I can't believe the captatin is making me change my shift from Security Station duty to be being a Tour Guide for any weirdos out there who just want others to state the obvious about the universe. Why does it have to be me? Anyway, I was also told to change the keypad locks for the Security Station, Armory, and the Food Market in case something goes down, not that anything will. The new combination is 00451. Also I'm recording this in case I forget myself from all this boredom I'm dealing with.

Staff Room
Hmmm....maybe that keycode is important.

>take keycode
Taken.